5
10
...#......
##.#.####.
.....#....
.#####.#.#
.....#....
